222222111111111111111
2     1             1
2     1       122 222
2     1       11   11
2         2   1    11
2     1  2    1     1
2      2      1     1
222222211111111111111