222222111111
2    c1   c1
2     1    1
2          1
2         21
2     1  2c1
2      2   1
222222211111