222222111111
2     1   c1
2     1 1111
2          1
222 2   1 21
2    11  2c1
2 c2  c2   1
222222211111