222222111111
2    c1c   1
2   221111 1
2          1
222 2   1 21
2    11  2c1
2 c222     1
222222211111